50 50
1000 1000
1 2 3 4 5 6 3 4 5 6 3 4 5 6 3 4 5 6 3 4 5 6 3 4 5 6 3 4 5 6 3 4 5 6 3 4 5 6 3 4 5 6 3 4 5 6 3 4 7 7
5 6 8 9 10 11 8 9 10 11 8 9 10 11 8 9 10 11 8 9 10 11 8 9 10 11 8 9 10 11 8 9 10 11 8 9 10 11 8 9 10 11 8 9 10 11 8 9 12 13
10 11 14 15 16 17 14 15 16 17 14 15 16 17 14 15 16 17 14 15 16 17 14 15 16 17 14 15 16 17 14 15 16 17 14 15 16 17 14 15 16 17 14 15 16 17 14 15 3 4
16 17 18 19 20 21 18 19 20 21 18 19 20 21 18 19 20 21 18 19 20 21 18 19 20 21 18 19 20 21 18 19 20 21 18 19 20 21 18 19 20 21 18 19 20 21 18 19 8 9
20 21 7 7 7 7 7 7 7 7 7 7 7 7 7 7 7 7 7 7 7 7 7 7 7 7 7 7 7 7 7 7 7 7 7 7 7 7 7 7 7 7 22 23 7 7 7 7 14 15
1 2 7 7 7 22 23 7 7 7 7 7 7 7 7 7 7 7 7 7 7 7 7 7 7 7 7 7 7 7 7 7 7 7 7 7 7 7 7 7 7 7 24 25 7 7 7 7 12 13
5 6 7 7 7 24 25 7 7 7 7 7 7 7 7 7 7 26 7 7 7 7 7 7 7 7 7 27 7 7 7 7 7 7 7 7 7 7 7 7 7 7 7 7 7 7 7 7 3 4
10 11 7 7 7 7 7 7 7 7 7 7 7 7 7 7 7 7 7 7 7 7 7 7 7 7 7 7 28 29 30 31 7 7 7 7 7 7 26 7 7 7 7 7 7 7 7 7 8 9
16 17 7 7 7 32 33 34 34 35 36 31 7 7 27 7 7 7 7 7 7 7 7 7 7 7 7 27 37 38 39 31 7 7 7 7 7 7 7 7 7 7 7 7 7 7 7 7 14 15
1 2 7 7 7 40 41 42 42 43 44 28 29 30 7 7 7 7 7 7 26 7 7 7 7 7 7 7 7 31 7 7 7 7 7 7 7 7 7 7 7 7 7 7 7 7 7 7 12 13
5 6 7 7 7 40 45 42 42 46 44 37 38 39 7 7 7 7 7 7 7 7 7 7 7 7 7 7 7 7 7 7 7 7 7 7 7 7 7 7 7 7 7 7 7 7 7 7 3 4
10 11 7 7 7 47 48 49 49 50 51 7 31 7 27 7 7 7 7 7 7 7 7 7 7 7 7 7 7 7 7 7 7 7 7 7 7 7 7 7 7 7 26 7 7 7 7 7 8 9
16 17 7 7 7 52 53 54 55 53 56 7 7 7 7 7 7 7 7 7 26 7 7 7 7 7 7 7 7 7 7 7 7 7 7 7 7 7 7 7 7 7 7 7 7 7 7 7 14 15
20 21 7 7 7 57 58 59 60 61 62 7 7 7 7 7 7 7 26 7 7 7 7 7 7 7 7 7 7 7 7 7 7 7 26 7 7 7 7 7 7 7 7 7 7 7 7 7 18 19
1 2 7 7 7 7 63 64 65 63 7 7 7 7 7 7 7 7 7 7 7 7 7 7 7 7 7 7 7 7 7 7 7 7 7 7 7 7 7 7 7 7 7 7 7 7 7 7 12 13
5 6 7 7 7 7 63 66 27 63 7 31 28 29 30 7 7 7 7 7 7 7 7 7 7 7 7 7 7 7 7 7 7 7 7 7 7 7 7 7 7 7 7 7 7 7 7 7 3 4
10 11 7 7 7 7 7 31 27 67 7 7 37 38 39 7 7 7 7 7 7 7 7 7 7 7 7 7 26 7 7 7 7 7 7 7 7 7 7 7 7 22 23 7 7 7 7 7 8 9
16 17 7 7 7 7 66 7 66 7 7 31 7 7 7 7 7 7 7 7 7 26 7 7 7 7 7 7 26 7 7 7 7 7 7 7 7 7 7 7 7 24 25 7 7 7 7 7 14 15
20 21 7 7 7 31 28 29 30 7 7 7 7 7 7 7 7 7 7 7 7 7 7 7 7 7 7 7 7 7 7 7 7 7 7 7 7 7 7 7 7 7 7 7 7 7 7 7 18 19
1 2 7 7 7 31 37 38 39 7 7 7 7 7 7 7 7 7 7 7 7 7 7 7 7 7 7 7 7 7 7 7 7 7 7 7 7 7 7 7 7 7 7 7 7 7 7 7 12 13
5 6 7 22 23 7 31 31 7 66 7 7 7 7 7 7 7 7 7 7 7 7 7 7 7 7 7 7 7 7 7 7 32 33 34 34 35 36 31 7 7 7 7 7 7 7 7 7 3 4
10 11 7 24 25 7 31 31 7 7 7 7 66 66 7 7 7 7 7 7 7 7 7 7 7 7 7 7 7 7 7 7 40 41 42 42 43 44 28 29 30 7 7 7 7 7 7 7 8 9
16 17 7 7 7 7 7 7 7 7 7 7 7 7 7 7 7 7 7 7 7 7 7 7 7 7 7 7 7 7 7 7 40 45 42 42 46 44 37 38 39 7 7 7 7 7 7 7 14 15
20 21 7 7 31 7 7 7 7 7 7 7 7 7 7 7 7 7 7 7 7 7 7 7 7 7 7 7 7 7 7 7 47 48 49 49 50 51 7 31 7 7 7 7 7 7 7 7 18 19
1 2 7 7 7 7 7 7 7 7 31 7 7 7 7 7 7 7 7 7 7 7 7 7 7 7 7 7 7 7 7 7 52 53 54 55 53 56 7 7 7 7 7 7 7 7 7 7 12 13
5 6 7 7 7 7 7 66 7 7 31 7 7 7 7 7 7 7 7 7 7 7 22 23 7 7 7 7 7 7 7 7 57 58 59 60 61 62 7 7 7 7 7 7 7 7 7 7 3 4
10 11 7 7 7 7 66 66 7 7 31 7 7 7 7 7 7 7 7 7 7 7 24 25 7 7 7 7 7 7 7 7 7 63 64 65 63 7 7 7 7 7 7 7 7 7 7 7 8 9
16 17 7 7 7 7 7 7 7 7 27 26 27 26 7 7 7 7 7 7 7 7 7 7 7 7 7 7 7 7 7 7 7 63 66 27 63 7 31 31 26 7 7 7 7 7 7 7 14 15
20 21 7 31 31 7 7 7 7 7 27 7 7 7 7 7 7 7 7 7 7 7 7 7 7 7 7 7 7 7 7 7 7 7 31 27 67 7 7 31 26 26 7 7 7 7 7 7 18 19
1 2 7 7 7 7 7 7 7 7 7 7 7 7 7 7 7 7 7 7 7 7 7 7 7 7 7 7 7 7 7 7 7 7 7 7 7 7 7 31 31 31 7 7 7 7 7 7 12 13
5 6 7 7 7 7 7 7 7 7 7 7 7 7 7 7 7 7 7 7 7 7 7 7 7 7 7 7 7 7 7 7 7 7 7 7 7 7 7 31 31 31 26 7 7 7 7 7 3 4
10 11 7 7 7 7 7 7 7 7 7 7 7 7 7 7 7 7 7 7 28 29 30 7 7 7 7 7 7 7 7 7 7 7 7 7 7 7 7 7 31 26 7 7 7 7 7 7 8 9
16 17 7 7 7 7 7 7 7 7 7 7 7 7 7 7 7 7 7 7 37 38 39 7 7 7 7 7 7 7 7 7 7 7 7 7 7 7 7 7 7 7 7 7 7 7 7 7 14 15
20 21 7 7 7 7 7 7 7 7 7 7 7 7 7 7 7 7 7 7 7 7 7 7 7 7 7 7 7 7 7 7 7 7 7 7 7 7 7 7 7 7 7 7 7 7 7 7 18 19
1 2 7 7 7 7 7 7 22 23 7 7 7 7 7 7 7 7 7 7 7 7 7 7 7 7 7 7 7 7 7 7 7 7 7 7 7 7 7 7 7 7 7 7 7 7 7 7 12 13
5 6 7 7 7 7 7 7 24 25 7 7 7 7 7 7 7 7 7 7 7 7 7 7 7 7 7 7 7 7 7 7 7 7 7 22 23 7 7 7 7 7 7 7 7 7 7 7 3 4
10 11 7 7 7 7 7 7 7 7 7 7 7 7 7 7 7 7 7 7 7 7 7 7 7 7 7 7 7 7 7 7 7 7 7 24 25 7 7 7 7 7 7 7 7 7 7 7 8 9
16 17 7 7 7 7 7 7 7 7 7 7 7 7 7 7 7 7 7 7 7 7 7 7 7 7 7 7 7 7 7 7 7 7 7 7 7 7 7 7 7 7 7 7 7 7 7 7 14 15
20 21 7 7 7 7 7 7 7 7 7 26 7 7 7 7 7 7 7 7 7 7 7 7 7 7 7 7 7 7 7 7 7 7 7 7 7 7 7 7 7 7 7 7 7 7 7 7 18 19
1 2 7 7 7 7 7 7 7 7 7 7 7 7 7 7 7 7 7 7 7 7 7 7 7 7 7 7 7 7 7 7 7 7 7 7 7 7 7 7 7 7 7 7 7 7 7 7 12 13
5 6 7 7 7 7 7 7 7 7 7 7 7 7 7 7 7 7 7 22 23 7 7 7 7 7 7 7 7 7 7 7 7 7 7 7 7 7 7 7 7 7 7 7 7 7 7 7 3 4
10 11 7 7 7 7 7 7 7 7 7 7 7 7 7 7 7 7 7 24 25 7 7 7 7 7 7 7 7 28 29 30 7 7 7 7 7 7 7 7 7 7 7 7 7 7 7 7 8 9
16 17 7 7 7 7 26 7 7 7 7 7 7 7 7 7 7 7 7 7 7 7 7 7 7 7 7 7 7 37 38 39 7 7 7 7 7 7 7 7 7 7 7 7 7 7 7 7 12 13
20 21 7 7 7 7 7 7 7 7 7 7 7 7 7 7 7 7 7 7 7 7 7 7 7 7 7 7 7 7 7 7 7 7 7 7 7 7 7 7 7 7 7 7 7 7 7 7 3 4
1 2 7 7 7 7 7 7 7 7 7 7 7 7 7 7 7 7 7 7 7 7 7 7 7 7 7 7 7 7 7 7 7 7 7 7 7 7 7 7 7 7 7 7 7 7 7 7 8 9
5 6 7 7 7 7 7 7 7 7 26 7 7 7 7 7 7 7 7 7 7 7 7 7 7 7 7 7 7 7 7 7 7 7 7 7 7 7 7 7 7 22 23 7 7 7 7 7 14 15
10 11 7 7 7 7 7 7 7 7 7 7 7 7 7 7 7 7 7 7 7 7 7 7 7 7 7 7 7 7 7 7 7 7 7 7 7 7 7 7 7 24 25 7 7 7 7 7 18 19
16 17 12 13 1 2 12 13 1 2 12 13 1 2 12 13 1 2 12 13 1 2 12 13 1 2 12 13 1 2 12 13 1 2 12 13 1 2 12 13 1 2 12 13 1 2 12 13 1 2
20 21 3 4 5 6 3 4 5 6 3 4 5 6 3 4 5 6 3 4 5 6 3 4 5 6 3 4 5 6 3 4 5 6 3 4 5 6 3 4 5 6 3 4 5 6 3 4 5 6
7 7 8 9 10 11 8 9 10 11 8 9 10 11 8 9 10 11 8 9 10 11 8 9 10 11 8 9 10 11 8 9 10 11 8 9 10 11 8 9 10 11 8 9 10 11 8 9 10 11
